F 76,76,76
C 99,99,99

NO img/a
SO img/b
WE img/a
EA img/a


                     1111111      
                     1000001
      111            1111101
      101                101
      101                101
1111111111111111111      101
1001001001001000001      101
1011000001000001001      101
1001001001111101111      101
1001111000001001001111111101
1000000000000001000000000001
1001111111111001001111111111
1111000000000N01011
1000000001111000001   111
1000000001  1000001   101
1000000001  1000001   111
1000000001111000001
1000011110000000001                 111
111111   1111111101                 101
1               10111111111111111111101
                10000000000000000000001
                11111111111111111111111
