F 123,44,76
C 111,90,99

NO ./assets/1644.png
SO ./assets/2264.png
WE ./assets/wall.png
EA ./assets/wall.png


                         111111      
                        1000001
         111             111101
         101                101
         101                101
   1111111111111111111      101
   1001001001001000001      101
   1011000001000001001      101
1111001001001111101111      101
1111001111000001001001111111101
   1000000000000001000000000001
   100111111111100100111111111  
   1111000000000001011
   100000000111100000111111
   10000N0001  1000000000101
   1000000001  100000111111
   1000000001110000001
   1000011110000000001                 111
   111111   1111111101                 101
   101             10111111111111111111101
    1              10000000000000000000001
                    1111111111111111111111