F 76,76,76
C 99,99,99

NO ../1644.png
SO ../2264.png
WE ../6673827.png
EA ../make-4-pixel-art-tiles-for-your-videogame.png


                         11111      
                        1000001
         111             111101
         101                101
         101                101
   1111111111111111111      101
   1001001001001000001      101
   1011000001000001001      101
1111001001001111101111      101
1111001111000001001001111111101
   1000000000000001000000000001
   100111111111100100111111111
   1111000000000N01011
   100000000111100000111111
   1000000001  1000000000101
   1000000001  100000111111
   1000000001110000001
   1000011110000000001                 111
   111111   1111111101                 101
   101             10111111111111111111101
    1              10000000000000000000001
                    1111111111111111111111


