


























































NO assets/1644.png
SO assets/2264.png
WE assets/png.png
EA assets/wall.png

F 98,105,109
C 80,130,200

 



















    1111111111111111111111111 
   10000000000000000000001      
  1000000000000001000000001      
 1000000000000000000000001
1000000000000000000000001
 1000000000001011110000001    
  10000000000001  100000001
   1000000000001  1000000001
  1000000000000011100000001
 100000000000N000000000001
1111111111111111111111111
