F 76,76,76
C 99,99,99

NO img/a
SO img/b
WE img/a
EA img/a

 1111
 1111
11111