F 001,44,76
C 111,90,99
 
NO assets/1644.png

SO assets/2264.png
WE assets/png.png
EA assets/wall.png


    1111111111111111111111111 
   10000000000N00000000001      
1111111111111111111111111



