F 76,76,76
C 99,99,99

NO img/a
SO img/b
WE img/a
EA img/a


1111111111111111111
1001001001001000001
1011000001000001001
1001001001111101111
1001111000001001001
1000000000000001001
1001111111111001001
1111000000000N01010
1000000001000000001
1111111111111111111


