NO  assets/wall.png

SO assets/wall.png

WE assets/wall.png

EA assets/wall.png

F 98,105,109
C 80,130,200

 
    1111111111111111111111111         
   100000000000000000000011     
  10000000000000010000000001      
 1000000000000000000N00000001
11000000000000000000000000001
1111000000000000000000001111
1000000000000000000000001
100000000000E000000000001
1000000110000000111000001
1000001 10000001  1000001
1111111 11111111  1111111